I reloaded with Windows 7 Ultimate, and the Bluetooth and Fingerprint reader (software) would not load.	Windows 7 Ultimate	negative
The service I received from Toshiba went above and beyond the call of duty.	service	positive
I do transcription work on the side, and the flatline keyboard makes typing quick and easy as well.	flatline keyboard	positive
The processor is very quick and effective as I load webpages and applications.	load	positive
I custom ordered the machine from HP and could NOT understand the techie due to his accent.	techie	negative
but it  has a major design flaw.	design	negative
10 hours of battery life is really something else....	battery life	positive
The operating system and user interface is very intuitive, and the large multi-touch track pad is amazing.	operating system	positive
There are no gold key numbers too intall programs, you must use the serial numbers that it does not accept and then things are limited as far a working because they are only good for a short time.	programs	negative
Now the screen is going darker, darker, darker.	screen	negative
I run Dreamweaver, Final Cut Pro 7, Photoshop, Safari, Firefox, MSN Messenger and a few other applications constantly at the same time.	applications	neutral
Before, I reloaded with Windows 7 Ultimate and used only the downloaded drivers from Acer's site.	drivers	neutral
also you may need to charge it once a day, if for medium use every thing fast and easy with mac  the size and look is the most feature that attracted me to it.	feature	positive
  The machine is slow to boot up and occasionally crashes completely.	boot up	negative
It is also very lightweight, making transporting this computer very easy.	transporting	positive
Features like the font are very block-like and old school.	font	negative
The pro is a great product, I wish that the 13 inch models came with the Intel i processors and had a more comfortable edge (the edges hurt my wrists).	edge	negative
Fast, great visual!	visual	positive
That whole experience was just ridiculous we sent it in and after they told us that we had to pay $175 to fix it we were like we will just by a portable mouse which would be way cheaper but they refused to send the laptop back until we paid the $175 and it was fixed.	mouse	positive
The other lock-up problems are from a myriad of causes, the most common being a corrupted version of Appleworks which can render the browser useless.	Appleworks	negative
) I also purchased  Applecare  for $300, which is a three year extended warranty, since I ve never seen any laptop that lasted more than two.	extended warranty	neutral
Love the graphics, awesome programs (including Garageband), and really cool default background.	default background	positive
They say it could be the motherboard again, but Dell	motherboard	negative
There are several programs for school or office use (Pages, Numbers, Keynote, etc.), music (Garageband), photo management (Photo Booth, iPhoto), video-editing or movie-making (iMovie), etc.	Photo Booth	neutral
In November my computer messed up entirely and wouldn't power on after intalling a Windows update, I had to have my HD flashed and lost EVERYTHING on it, including my school assignments and irriplaceable pictures that were only in digital format and several other things, when this update was installed for some reason I was unable to roll back the drivers and everything to an earlier working condition because when the update was installed it deleted my history.	Windows update	neutral
But with A WAY Bigger Screen, and IS able to connect to an HDMI.	Screen	positive
 THE MOTHERBOARD IS DEAD !	MOTHERBOARD	negative
  Until I bought the Dell, I thought you just looked for what you wanted (size, software, options, hardware) and purchase the best deal you could find.	software	neutral
For the Bluetooth to work properly, you must install the Launch Manager on the Drivers/Applications DVD, or it will not show after the reload.	Bluetooth	neutral
A cheaper price should not equal a "cheap" product.	price	positive
Yes, they cost more, but they more than make up for it in speed, construction quality, and longevity.	speed	positive
I took it in to the Apple store and guess what? They fixed it, no cost out of pocket.	cost	negative
Or the cursor would show up some place else.	cursor	negative
Again, decent comp for the price, and I was in need of one quickly as my other laptop died on me.	price	positive
The AC power port becomes loose over time	AC power port	negative
Great battery, speed, display.	display	positive
Maybe this is virus related, maybe not, but the computer has locked up many times, and on two occasions, the screen has simply gone black.	screen	negative
If your time is worth anything to you, if you are tired of rebooting, reformatting, reinstalling, trying to find drivers, if you want a computer to work for you for a change, make the change to this computer.	drivers	negative
Some features arent friendly ( volume wheel, sound quality, etc.	sound quality	negative
Now when I order I did not go full scale for the webcam or full keyboard I wanted something for basics of being easy to carry when I use crutchs or wheelchair and with a backpack laptop bag.	webcam	neutral
I find myself using the 10-key more than I thought I would.	10-key	positive
The performance is awesome.	performance	positive
The display is beyond horrible.	display	negative
then on top of it all their cusromer service center is in the middle east.	cusromer service center	negative
When it come time for warranty service to Toshiba you don't matter.	warranty service to Toshiba	neutral
You can even run a parallels type program easily and run any leftover PC software that you absolutely cannot be without.	software	positive
Simple to use, and great graphics.	graphics	positive
Setting would change for some reason, the screen size would change on it's own, like the pixel sizes and whatnot.	screen size	negative
Screen, keyboard, and mouse: If you cant see yourself spending the extra money to jump up to a Mac the beautiful screen, responsive island backlit keyboard, and fun multi-touch mouse is worth the extra money to me alone.	island backlit keyboard	positive
Screen is crystal clear and the system is very responsive.	system	positive
Of course, I inspected the other netbooks and clearly their hinges are tighter and I even demonstrate the difference between my netbook and others.	hinges	negative
I was looking for a mac which is portable and has all the features that I was looking for.	features	positive
Despite the claims of the Apple apologists (a vice of which I am recently myself reformed) the internals of Mac laptops are NO different from PCs' at this point.	internals	negative
I do not experience a lot of heat coming out of it, however I would highly suggest purchasing a stand however, due to the nature of the design of the macbook as it is one very large heat sink.	stand	neutral
I purchased a Toshiba Satellite M60 (with harman/kardon speakers!) in December of 2005.	speakers	positive
Once again, I was told it was the suspicious  power supply  problem.	power supply	negative
The online tutorial videos make it super easy to learn if you have always used a PC.	online tutorial videos	positive
I'm tired of the inept service.	service	negative
  This time the mouse pad and right click key wouldn't work!	right click key	negative
they improved nothing else such as Resolution, appearance, cooling system, graphics card, etc.	cooling system	negative
I wish the volume could be louder and the mouse didnt break after only a month.	volume	negative
Everything from the design to the OS is simple and to the point.	design	positive
Awesome graphics!	graphics	positive
I love the operating system and the preloaded software.	preloaded software	positive
The paint wears off easily due to the keyboard being farther back than usual.	paint	negative
All the programs are easy and straight forward on my MacBook Pro, it is clean and organized, which I always strive to be myself.	programs	positive
The Mac Snow Leopard O/S is extremely easy to use, although very different than Win XP, Visa or Win7.	Win7	neutral
I had my IWORKS, Itunes, Email, MS Office, network and printers set up and completely working perfectly within an hour.	Itunes	positive
I also purchased iWork to go with it which has programs for word processing, spreadsheets, and presentations (similar to Microsoft Office).	presentations	neutral
Its pretty fast and does not have hiccups while I am using it for web browsing, uploading photos, watching movies (720p) on occasion and creating presentations.	uploading photos	positive
  i must keep it plugged in at all times because it will not keep a charge for longer than four minutes.	charge	negative
And the ram (the thing that makes it faster) comes sporting 2 gigs for high performance to handle more stuff at once and surf the web a whole lot faster than before.	surf the web	positive
It's just as fast with one program open as it is with sixteen open.	program	neutral
The repairs were made quickly though I must say, however the second time they shipped it to the incorrect address and it took nearly a week for them to get it to me.	shipped	negative
The dv4 boasted a faster processor, more memory, and a bigger hard drive than my old computer, plus a better quality web cam, nicer screen, and many other features.	processor	positive
Now,,,,,my monitor has been acting up for about 2 months.	monitor	negative
The trackpad was easy to learn and navigate.	trackpad	positive
But sitting on a lap or on a desk in front of you it looks more than big enough (this could be because Im used to my Lenovo 10 tablet now) plus this is a great size if I want to unplug the external keyboard, mouse, and monitor to take it with me when I take photos and video.	external keyboard	neutral
Only thing I would want to add to this is an internal bluray read/write drive.	bluray read/write drive	negative
I bought this last week, and the very next day had to return it because it over heated and the touch-mouse stopped responding.	touch-mouse	negative
Not to mention, the battery life is absolutely amazing.	battery life	positive
I also got the added bonus of a 30" HD Monitor, which really helps to extend my screen and keep my eyes fresh!	30" HD Monitor	positive
Processor - When compared to my 3 week old Early 2011 edition there I barely experience any difference in performance (2.3 GHz v/s 2.4 GHz).	performance	neutral
The computer runs very fast with no problems and the iLife software that comes with it (iPhoto, iMovie, iWeb, iTunes, GarageBand) is all very helpful as well.	iLife software	positive
My ONLY issues are: 1) the screen/video resolution won't increase to a higher resolution then 1024 x 60	resolution	negative
Registration/1st use is easy.	use	positive
I would not recommend this to anyone wanting a notebook expecting the performance of a Desktop it does not meet the expectations.	performance	negative
More times that not the screen pops up saying I have a bad internet connection, or the page can't be displayed.	internet connection	negative
Very fast boot up and shut down.	boot up	positive
This computer doesn't do that well with certain games it can't play some and it becomes too hot while playing games.	games	negative
you can find many laptops with the same performance and even better with lower price, but you cannot find the look, easy, applications, and the experience in mac.	price	positive
They gave me a hard time yet again, but their was a malfunction in the battery itself, it didn't die.	battery	negative
My husband uses it mostly for games, email and music.	games	neutral
10 plus hours of battery...	battery	positive
Since I keyboard over 100 wpm, I look for a unit that has a comfortble keyboard (no keys sticking or lagging, strange configuration of "extra key", etc.	keys	positive
  My opinion of Sony has been dropping as fast as the stock market, given their horrible support, but this machine just caused another plunge.	support	negative
  Another THREE weeks later I had my laptop back with a new mousepad, keys, and casing.	keys	neutral
Its pretty fast and does not have hiccups while I am using it for web browsing, uploading photos, watching movies (720p) on occasion and creating presentations.	creating presentations	positive
 A coupla months later, they change my hard drive.	hard drive	negative
I work in film editing and post production, so I need a laptop that not only has power, but memory and speed as well.	memory	neutral
Have not yet needed any customer support with this yet so to me that is a great thing, which is leaps and bounds ahead of PC in my opinion.	customer support	positive
Also, because of the size and consistancy of the laptop computer, some websites wouldn't even attempt to work on the computer because of browser problems.	consistancy	negative
It's also very capable of doing moderate video editing (although you may need the performance boost of the larger MacBook Pros for heavy duty mobile video editing).	mobile video editing	neutral
There are several programs for school or office use (Pages, Numbers, Keynote, etc.), music (Garageband), photo management (Photo Booth, iPhoto), video-editing or movie-making (iMovie), etc.	iPhoto	neutral
) I also purchased  Applecare  for $300, which is a three year extended warranty, since I ve never seen any laptop that lasted more than two.	Applecare	neutral
After talking it over with the very knowledgeable sales associate, I chose the MacBook Pro over the white MacBook.	sales associate	positive
  The board has a bad connector with the power supply and shortly after warrenty expires the power supply will start having issues.	connector	negative
After numerous calls to Applecare tech support, I was directed to send in my computer;	Applecare tech support	negative
The start menu is not the easiest thing to navigate due to the stacking.	start menu	negative
The screen is a little glary, and I hated the clicking buttons, but I got used to them.	screen	negative
Acer was no help and Garmin could not determine the problem(after spending about 2 hours with me), so I returned it and purchased a Toshiba R700 that seems even nicer and I was able to load all of my software with no problem.	software	positive
iTunes is a handy music-management program, and it is essential for anyone with an iPod.	iTunes	positive
The best thing to do is build your own computer, but if u can't company's like dell who allow you to choose the components are better and for the same price you can get a computer who compares to one of apple $2000 systems and if you google "dell coupons" you can find codes that take a signifant  amount off the price.	components	positive
BEST BUY - 5 STARS + + + (sales, service, respect for old men who aren't familiar with the technology) DELL COMPUTERS - 3 stars DELL SUPPORT - owes a me a couple	service	positive
STOPPED BOOTING UP less than a week after my one-year warranty was up.	one-year warranty	neutral
Good keyboard, long battery life, largest hard drive and windows 7.	battery life	positive
The Bluetooth was not there at all, and the fingerprint reader driver would be there, but the software would hang after installation was 1/2 way done.	software	negative
while about 8 years ago, I hope that the quality has changed.	quality	negative
Everything I have tried has worked and I never have to carry the wall charger cause the battery is so awesome.	battery	positive
I work in film editing and post production, so I need a laptop that not only has power, but memory and speed as well.	speed	neutral
It is fast booting up , shutting down, and connection with the internet.	connection with the internet	positive
I eventually did the migration from my iMac backup disc which uses USB.	USB	neutral
PC users work in Word, while Mac users work in Pages.	Word	neutral
Navigation through the computer is far superior compared to Windows operating systems, as well.	Navigation	positive
The graphics are great.	graphics	positive
But the arm velcro is torn after one use.	arm velcro	negative
Summary: They played games with me for the warranty period.	warranty period	negative
it has 3 usb ports, 1 sd memory card reader and an sd memory car expansion.	usb ports	neutral
The difference is the Toshiba had a lot more memory and hard drive space.	hard drive space	positive
It has easy to use features and all the speed and power I could ask for.	speed	positive
Nightly my computer defrags itself and runs a virus scan.	virus scan	neutral
I now realize that my $900 would have been better spent on a Windows laptop.	Windows	positive
It didn't come with any software installed outside of windows media, but for the price, I was very pleased with the condition and the overall product.	price	positive
So I called customer support (which is good too) and they went through it and it is just a safety feature and it does not affect performance at all, I just chose to hide the message.	customer support	positive
The Toshiba laptop I am using is easier to use than most I have tried.	use	positive
it is of high quality, has a killer GUI, is extremely stable, is highly expandable, is bundled with lots of very good applications, is easy to use, and is absolutely gorgeous.	GUI	positive
All the things you can do with the trackpad make navigating around the computer and its programs so much simpler, quicker, and easier.	navigating	positive
Temperatures on the outside were alright but i did not track in Core Processing Unit temperatures.	Temperatures	neutral
Great battery, speed, display.	speed	positive
As with any laptop not purchased with software options, it comes with a lot of what I consider useless applications.	applications	negative
It has easy to use features and all the speed and power I could ask for.	features	positive
Like the price and operation.	operation	positive
I am enjoying it and the quality it provides is great!	quality	positive
Well, I have to say since I bought my Mac, I won't ever go back to any Windows.	Windows	negative
I have no idea how to burn cd's or to use the web cam, just for starters.	burn cd's	neutral
With all the programs that came with it, such as iLife and iWork, I was set from the very beginning.	iWork	neutral
so in a brief summary i would have to say that i would not recommend dell vostro 1000 to anyone due to it being a down right awful setup so in my opinion you should steer clear of them if you want a decent laptop.	setup	negative
One more tip, please purchase this model and get a 4GB stick of RAM to save you $10	4GB stick of RAM	positive
It had a cooling system malfunction after 10 minutes of general use, and would not move past this error.	use	neutral
For me, keys were starting to get stuck and wouldn't type very well.	keys	negative
It drives me crazy when I want to download a game or something of that nature and I can't play it because its not compatable with the software.	software	negative
Its fast and another thing I like is that it has three USB ports.	USB ports	positive
Yes, the computer was light weight, less expensive than the average laptop, and was pretty self explantory in use.	use	positive
MY ONLY PROBLEM IS I CAN NOT REG. THE PRODUCT KEY.	PRODUCT KEY	negative
It absolutely is more expensive than most PC laptops, but the ease of use, security, and minimal problems that have arisen make it well worth the pricetag.	security	positive
It even has a great webcam, and Skype works very well.	Skype	positive
I also had a problem with the touchpad that caused the mouse pointer to jump all over the screen.	screen	neutral
There are several programs for school or office use (Pages, Numbers, Keynote, etc.), music (Garageband), photo management (Photo Booth, iPhoto), video-editing or movie-making (iMovie), etc.	photo management	neutral
Everything is so easy to use, Mac software is just so much simpler than Microsoft software.	Mac software	positive
I am forever changed and will no longer buy a Windows based machine for personal use.	Windows	negative
I acually believe the issue is with the Nvidia grafics card, but still requires a return.	Nvidia grafics card	negative
I also had a problem with the touchpad that caused the mouse pointer to jump all over the screen.	touchpad	negative
Did I mention everything about it, from size to weight to keyboard screams BULK?	keyboard	negative
The notebook is lacking a HDMI port and a S-video port that would enable one to hook it to a TV.	S-video port	negative
Getting the Apple Care plan is a must.	Apple Care plan	positive
My favorite part of this computer is that it has a vga port so I can connect it to a bigger screen.	screen	neutral
I just took the broken cords into the Apple store and they gave me new ones.	cords	positive
Very fast boot up and shut down.	shut down	positive
Also consider the MS Office apps are all trial versions, hope you have your own copies.	MS Office apps	negative
The quality, engineering design and warranty are superior--covers damage from dropping the laptop.	warranty	positive
However, my girlfriend realized that the netbook's hinge is a bit loose (when you open or close the LCD).	LCD	neutral
Most everything is fine with this machine: speed, capacity, build.	speed	positive
the mouse on the pad, the left button always sticks.	left button	negative
When I got the computer back and realizwed it still was not correct HP told me it was out of warranty and now it was my problem.	warranty	neutral
Asked the customer service rep.	customer service rep	neutral
I work in film editing and post production, so I need a laptop that not only has power, but memory and speed as well.	power	neutral
Also the display is exceptional!	display	positive
Good keyboard, long battery life, largest hard drive and windows 7.	hard drive	positive
Maximum sound isn't nearly as loud as it should be.	Maximum sound	negative
I recommend for word processing and internet users.	internet	positive
I reinstalled windows through the recovery discs and everything seemed good again.	recovery discs	positive
I have in the past gotten superfine sandpaper and "fixed" the edges by rounding them off.	edges	negative
Great laptop for school, easy to use for beginners in the household.	use	positive
I also love the design, the looks, the feel, and the my toshiba feature is wonderfull.	my toshiba feature	positive
Laptop is advertised as a 15" but the casing looks like that of a 17".	casing	negative
The screen graphics and clarity, and sharpness are great.	sharpness	positive
While I mostly use it for email, internet and gaming, I'm confident all other applications live up to the high standard I've come to appreciate from Mac laptops.	applications	positive
I think that if it is the motherboard again so soon that they should replace it.	motherboard	negative
I charge it at night and skip taking the cord with me because of the good battery life.	battery life	positive
Some features arent friendly ( volume wheel, sound quality, etc.	volume wheel	negative
The laptop is outstanding in all aspects except that it has the Windows 7 starter and not the full Windows 7.	Windows 7	positive
Needs Power and Mouse Cable to Plug in back instead of side, In the way of operating a mouse in small area.	Mouse Cable	negative
I reinstalled windows through the recovery discs and everything seemed good again.	windows	positive
The design is awesome, quality is unprecedented.	design	positive
The programs that come standard with the Leopard running system are enough for the average person to run all the basics.	Leopard running system	neutral
Is this partially due to the fact that it is running Windows Vista?	Windows Vista	neutral
4) Laptop still did not work, blue screen within a week...	work	negative
After doing extensive research, macconnection had the lowest price on the 15" MBP i5.	price	positive
The computer was shipped to their repair depot  on june 24 and returned on July 2 seems like a short turn around time except the computer was not repaired when it was returned.	repair depot	neutral
Dell's customer disservice is an insult to it's customers who pay good money for shoddy products.	Dell's customer disservice	negative
It has plenty of memory, lots of hard drive, and great graphics.	memory	positive
(I had been a Windows/Linux user before this) I love the size because the screen is big enough for what I use it for (Internet, artwork), and yet it is small enough to be reasonably portable.	screen	positive
A mac is very easy to use and it simply makes sense.	use	positive
It is fast and i have not had a problem with internet connection or any other problems.	internet connection	positive
Great value, fast delivery- Computer works as if brand new, no problems, very pleased	value	positive
This laptop looks great on the surface: 17" inch screen, good  price-point, nice appearance, boots up quickly, runs fast etc.	appearance	positive
The battery holds up well, it's built very solidly, and runs fast.	built	positive
Apparently well-built and gorgeous to look at, the i5 MacBook Pro is a winning combination of price and performance.	built	positive
The screen is framed by half- to a full-inch margin that is obviously unnecessary, reduces the screen size and increases the bulk.	screen size	negative
I've owned this labtop for less then two months, already the mouse button has broke.	mouse button	negative
super fast processor and really nice graphics card..	graphics card	positive
Supplied software: The software that comes with this machine is greatly welcomed compared to what Windows comes with.	Supplied software	neutral
Another thing is that after only a month the left mouse key broke and it costed $175 to send it in to fix it.	costed	neutral
After purchasing this thing, I find out that I need a special interface device to connect my camera, and that it cannot be purchased at the store - only on line.	interface device	negative
The unibody design is edgy and durable.	unibody design	positive
I don't have stupid pop up windows (even when I have pop ups blocked), I don't have to wait 5 minutes for a webpage to download, and best of all I can run all the web programming software I need to use all at once without slowing me down.	pop up windows	positive
The acer one computer that I bought is 17 ince screen and its hard to find lap top bags for it, but I like the big screen on it.	screen	positive
It gives me the power and speed that I need to run all the programs I use to edit.	power	positive
I needed a driver for my HP and they would not help me with out me paying over $50 for it.	driver	neutral
No temporary replacement, they are out of replacements because "many computers had problems with the Nvidia chipset"-Inquired status of repair.	Nvidia chipset	negative
The reflectiveness of the display is only a minor inconvenience if you work in a controlled-lighting environment like me (I prefer it dark) or if you can crank up the brightness.	display	negative
Good monitor and performed well.	monitor	positive
The processor screams, and because of the unique way that Apple OSX 16 functions, most of the graphics are routed through the hardware rather than the software.	OSX 16	positive
I ordered through MacMall, which saved me the sales tax I would have incurred buying locally.	sales tax	positive
It has a 10 hour battery life when you're doing web browsing and word editing, making it perfect for the classroom or office, and in terms of gaming and movie playing it'll have a battery life of just over 5 hours.	web browsing	neutral
But sitting on a lap or on a desk in front of you it looks more than big enough (this could be because Im used to my Lenovo 10 tablet now) plus this is a great size if I want to unplug the external keyboard, mouse, and monitor to take it with me when I take photos and video.	size	positive
Amazing Quality!	Quality	positive
While I mostly use it for email, internet and gaming, I'm confident all other applications live up to the high standard I've come to appreciate from Mac laptops.	internet	neutral
The only bad part is the size/weight.	weight	negative
You have to toss out the wifi card and replace it just to have any sort of network capability.	network capability	negative
  It is easy to use, fast and has great graphics for the money.	use	positive
The store honored their warrenty and made the comment that they don't even recommend the HP brand because of the problems with their warrentys.	warrenty	positive
 I actually had the hard drive replaced twice, the mother board once, the dvd drive twice, then they FINALLY agreed to replace it, (ALL OF THIS IN LESS THAN 1 1/2 YEARS!	dvd drive	negative
It is easy to navigate and update programs.	update programs	neutral
In addition, all the design tools on Pages and Keynotes makes it much easier to create professional looking documents and presentations.	Pages	positive
What I'd like is for the laptop to run well without having to purchase additional memory.	memory	negative
It is extremely portable and easily connects to WIFI at the library and elsewhere.	connects to WIFI	positive
Apparently there is a manufacturing defect, something with the amount of thermal paste.	thermal paste	negative
     First it burned or fused the power adapter plug.	power adapter plug	negative
It's even easy to hook up to other wireless networks.	hook up to other wireless networks	positive
The newer black keyboard took a little bit away from the previous gray one which looked really slick, but it is still a great notebook!	black keyboard	negative
Downfalls: sharp edges.	edges	negative
I bought this laptop and found its TAB is not functioning.	TAB	negative
Garageband is more for the musicians, and the laptop is equipped with a good working microphone, good enough for beginners and musicians at the intermediate level.	microphone	positive
I had of course bought a 3 year warranty, so I sent it in to be replaced and (almost 2 months later) the dv4 is what the sent me as a replacement.	3 year warranty	neutral
It is so much easier to use	use	positive
With all the programs that came with it, such as iLife and iWork, I was set from the very beginning.	programs	neutral
My friend reports the notebook is astonishing in performance, picture quality, and ease of use.	performance	positive
I can barely use any usb devices because they will not stay connected properly.	usb devices	negative
The real stand out on this computer is the feel of the keyboard and it's speed.	keyboard	positive
Newegg's RMA service was great as always, I contacted them late Friday night, and they issued me an RMA number and a PrePaid UPS shipping label the very next morning on Saturday.	RMA service	positive
Apple is always great about the aesthetics of things, they always come up with good looking products.	aesthetics	positive
  Sometimes the screen even goes black on this computer.	screen	negative
I run windows via bootcamp for the couple programs I do not want to buy a mac version of, like my cad programs.	cad programs	neutral
Microsoft seems to be unable to keep up with repairs for the multitude of windows problems.	windows	negative
I love WIndows 7 which is a vast improvment over Vista.	WIndows 7	positive
This laptop is a great price and has a sleek look.	look	positive
  I was also able to install and use my Photoshop and AfterEffects programs easily.	AfterEffects programs	positive
Some features arent friendly ( volume wheel, sound quality, etc.	features	negative
I like those programs better than Office and you can save your files to be completely compatible with the Office programs as well.	Office programs	neutral
Great battery, speed, display.	battery	positive
With a mac you don't have to worry about antivirus software or firewall, it's so wonderful.	firewall	neutral
It has bein into the shop to get a new hardrive 2 times and to fix the touch control buttons on the keyboard!	hardrive	negative
The size is perfect and I do not recomend anything bigger except for any person who can exceed the limited space it gives you.	size	positive
I dual boot with Linux and that other security-prone OS and it performs flawlessly.	security-prone OS	neutral
I am not much of a computer techie, so I can understand some of the internal problems, though I do have trend micro as an antiviral program.	trend micro	neutral
If internet connectivity is important I would recommend going with a dell net book for 50 bucks more, or buy a USB wireless card.	USB wireless card	neutral
The salesman talked us into this computer away from another we were looking at and we have had nothing but problems with software problems and just not happy with it.	software	negative
The speed difference is next to NOTHING for a mac, and the hard drive can be manually upgraded or you could just buy a $60 500gb external hard drive.	500gb external hard drive	neutral
Externally the keys on my keyboard are falling off, after a few uses the paint is rubbing off the button below the mouse pad and where the heals of my hands sit, and the screen has a terrible glare.	keyboard	negative
There also seemed to be a problem with the hard disc as certain times windows loads but claims to not be able to find any drivers or files.	hard disc	negative
Speakers doesn't sound that great.	Speakers	negative
They don t translate from a Mac, even on Word, resulting in a ton of run-on sentences.	Word	negative
Though the picture, video, and music software is nowhere close to professional grade software Im used to (CS5) but does the job for beginner and even intermediate media designers.	software	positive
I have only had PCs with Windows before so this takes a little getting use to.	Windows	neutral
company provides UPS shipping, fast, great!	shipping	positive
I wiped nearly everything off of it, installed OpenOffice and Firefox, and I am operating an incredibly efficient and useful machine for a great price.	OpenOffice	neutral
I always use a backup hard disk to store important files at all times.	hard disk	neutral
We love the size of the screen, although it is still lightweight and very easy to tote around.	size of the screen	positive
the graphics are awful and the wireless switch it at the top rather than the side which I am used to it being on the side.	wireless switch	negative
I personally like the gaming look but needed a machine that delivered gaming performance while still looking professional in front of my customers.	gaming performance	positive
Yeah, of course smarty pants "fix it now")Software - Compared to the early 2011 edition I did see inbuilt applications crashing and it prompted me to send the report to Apple (which I promptly did).	Software	negative
I loaded windows 7 via Bootcamp and it works flawlessly!	windows 7	positive
We upgraded the memory to four gigabytes in order to take advantage of the performace increase in speed.	performace	positive
Upgrading from Windows 7 Starter, thru Windows 7 Home Premium, to Windows 7 Professional was a snap;	Windows 7 Home Premium	neutral
it is of high quality, has a killer GUI, is extremely stable, is highly expandable, is bundled with lots of very good applications, is easy to use, and is absolutely gorgeous.	quality	positive
It is easy to use, good quality and good price.	use	positive
Again in February my computer completely failed to the point that it could not load Windows so I contacted Acer to get it fixed thru my Warrenty and it took about 3 days fighting on the phone with agents and it seemed as though NONE of them spoke English.	Warrenty	neutral
Also, because of the size and consistancy of the laptop computer, some websites wouldn't even attempt to work on the computer because of browser problems.	size	negative
The store honored their warrenty and made the comment that they don't even recommend the HP brand because of the problems with their warrentys.	warrentys	negative
Do yourself a favor and invest in a few external harddrives if you are planning on purchasing this laptop.	external harddrives	negative
The Material this Pro is made out of seems a lot nicer than any PC  Specs: Like I said this performs a lot better than any computer I've had in the past.	Specs	negative
Mac also has many apps and programs that are quite cheap or free.	apps	positive
Great product, very easy to use and great graphics.	use	positive
Plain and simple, it(laptop) runs great and loads fast.	loads	positive
It is easy to use and lightweight.	use	positive
the laptop preformed pretty well.	preformed	positive
I also purchased iWork to go with it which has programs for word processing, spreadsheets, and presentations (similar to Microsoft Office).	spreadsheets	neutral
As a computer science student in college, I find that the portability, longevity, and ease of use of this computer make me (shockingly) want to do homework more;	use	positive
Great Laptop for the price, works well with action pack games.	price	positive
It was secure and easy to navigate.	navigate	positive
I have had to call with a few questions or issues and they have helped me for free, even without the warranty.	warranty	neutral
Anyways I bought this two months ago and when I first brought it home it kept giving me a message about a vibration in the hard drive and it is putting it temporaly in save zone.	hard drive	negative
I run Dreamweaver, Final Cut Pro 7, Photoshop, Safari, Firefox, MSN Messenger and a few other applications constantly at the same time.	Dreamweaver	neutral
The iLife software that comes with the computer is so simple to use and produces a great finished product.	iLife software	positive
We use the built in tools often, iTunes is open nearly every day and works great with my iPhone.	iTunes	positive
Its also FUN to use!	use	positive
The dv4 boasted a faster processor, more memory, and a bigger hard drive than my old computer, plus a better quality web cam, nicer screen, and many other features.	hard drive	positive
DO NOT BUY GATEWAY COMPUTERS THEY ARE JUNK AND THE WARRANTY COMPANY IS HORRIBLE.	WARRANTY COMPANY	negative
The computer runs very fast with no problems and the iLife software that comes with it (iPhoto, iMovie, iWeb, iTunes, GarageBand) is all very helpful as well.	iTunes	positive
That included the extra Sony Sonic Stage software, the speakers and the subwoofer I got (that WAS worth the money), the bluetooth mouse for my supposedly bluetooth enabled computer, the extended life battery and the Docking port.	bluetooth mouse	neutral
The difference in the Apple keyboard from a PC's keyboard took a bit of tim to get used to, but overall it's worth it!	Apple keyboard	neutral
Only other thing is that if you are using this for document creation Apple doesnt provide any kind of word processor (such as works for windows), but iwork is cheap compared to office.	windows	neutral
Strong performance in this device makes use of fun and a strong sense of the era of speed This device serves all modern requirements is a very strong game and is very useful for designers.	use	positive
I would like at least a 4 hr. battery life.	battery life	neutral
True quality at a great price!	quality	positive
Other than that, I would recommend this to someone in need of a cheap laptop with semi-decent gaming capabilities.	gaming	positive
Because we did not purchase the extended warranty in time, we are on the hook for the repair.	extended warranty	negative
  I continued to take the computer in AGAIN and they replaced the hard drive and mother board yet again.	mother board	negative
I regret buying it before understanding how awful it is to use.	use	negative
Garageband is easy to work with, like all the other apple applications I've had experience with.	apple applications	positive
the mouse buttons are hard to push.	mouse buttons	negative
My laptop now has no battery.	battery	negative
One drawback, I wish the keys were backlit.	keys	negative
Could not keep up with me and finally the hard drive went out.	hard drive	negative
The Bluetooth was not there at all, and the fingerprint reader driver would be there, but the software would hang after installation was 1/2 way done.	fingerprint reader driver	negative
I guess the only good thing that came out of these were the speakers and the subwoofer.	speakers	positive
The system constantly overheats, the battery life is too short, the case is coming apart, and my core applications that I use every day in my work as a graphic artist run poorly.	system	negative
Even doing so, the hinge may just be slightly tightened only.	hinge	neutral
I just plug this into my 22" Monitor and the speedy MacOSX performs just as well on this dual-core that my Dell did with Windows 7 with a quad-core.	MacOSX	positive
I also purchased iWork to go with it which has programs for word processing, spreadsheets, and presentations (similar to Microsoft Office).	word processing	neutral
But to be honest, the compatibility issues and the other little quirks make me think I ll buy a PC next time.	compatibility	negative
Asus facial recognition doesn't work and windows logon isn't either.	facial recognition	negative
The buttons you have to press a little harder than most.	buttons	negative
Its ease of use and the top service from Apple- be it their phone assistance or bellying up to the genius bar- cannot be beat.	phone assistance	positive
In the first moth of owning this computer its hardrive failed which had to be replaced.	hardrive	negative
  also the battery is completely shot.	battery	negative
Great product, very easy to use and great graphics.	graphics	positive
I was originally concerned that I couldn't view work I had done in college on my Mac because of the PC formatting, but I was even more thrilled to learn of programs like iLife and iWork that allow you to convert your PC documents into readable files on Macs.	programs	positive
It did fairly well, other than it's poor performance, overheating and occational blue screen.	performance	negative
Startup in about 30 seconds, shutdown in 2-4 seconds, resume from sleep in 0-2 seconds.	shutdown	neutral
For the Bluetooth to work properly, you must install the Launch Manager on the Drivers/Applications DVD, or it will not show after the reload.	Drivers/Applications DVD	neutral
Support has been lackluster and now I just want a refund.	Support	negative
The large screen gives you the option to comfortably watch movies or TV shows on your computer instead of buying an additional TV for your dorm room.	screen	positive
  Only a few days after I received the computer back, the screen froze again.	screen	negative
The battery life is probably an hour at best.	battery life	negative
Again- windows based machines were not giving me anything to work with!	windows	negative
I would tell the technician I knew exactly what was wrong with it but they did not listen and I had to go through a bunch of junk to get them to tell me I needed to send the computer in.	technician	negative
Drivers updated ok but the BIOS update froze the system up and the computer shut down.	BIOS update	negative
Called tech support and got the usual Acer "We don't support software but for $$$ we can help you" I explained there was no software involved in booting.	booting	negative
Obviously one of the most important features of any computer is the "human interface.	features	neutral
It didn't come with any software installed outside of windows media, but for the price, I was very pleased with the condition and the overall product.	windows media	neutral
Love the stability of the Mac software and operating system.	operating system	positive
Even though it is running Snow Leopard, 2.4 GHz C2D is a bit of an antiquated CPU and thus the occasional spinning wheel would appear when running Office Mac applications such as Word or Excel.	spinning wheel	negative
The switchable graphic card is pretty sweet when you want gaming on the laptop.	switchable graphic card	positive
For the [$] price (special offer) this is a great laptop.	price	positive
For some odd reasons the computer doesn't reconize the operation system.	operation system	negative
If you want a little more custom ability, drop a few bucks and upgrade to one of the more robust versions of Win 7 and grab a 2GB stick of memory to spice it all up a bit more.	2GB stick of memory	positive
It has many great programs, such as ILife, iPhotos and others.	programs	positive
I would recommend it just because of the internet speed probably because thats the only thing i really care about.	internet speed	positive
It's also very capable of doing moderate video editing (although you may need the performance boost of the larger MacBook Pros for heavy duty mobile video editing).	video editing	positive
The keyboard is too slick.	keyboard	negative
Of course, I also have several great software packages that came for free including iWork, GarageBand, and iMovie.	iMovie	positive
 One night I turned the freaking thing off after using it, the next day I turn it on, no GUI, screen all dark, power light steady, hard drive light steady and not flashing as it usually does.	screen	negative
I was loving this Netbook because it had an amazing screen and display and was small and light, but after 1 week it stopped openning web pages for me (even after installing new browsers) then eventually it just started giving me a blue screen and crashing everytime I booted it.	browsers	neutral
When we bought our new HP comouter in Dec. of 2008, we wanted Windows XP, but were told it would cost an extra $159, so we went with Vista.	Vista	neutral
I love the solid machined aluminum frame, and the keyboard is the best of any laptop I've used.	machined aluminum frame	positive
Microsoft word was not on it andI had to buy it seperately.	Microsoft word	negative
I'm having the laptop returned unrepaired since paying $176 every 3  months just isn't worth it (that's about how long the port seems to  last).	port	negative
The much lauded combined touch pad and clicker is a nightmare.	combined touch pad and clicker	negative
the mouse on the pad, the left button always sticks.	mouse on the pad	neutral
3) Horrible customer support	customer support	negative
The Windows 7 Starter is, in my opinion, a great way to think about using your netbook: basics, basics, basics.	Windows 7 Starter	positive
The tech guy then said the service center does not do 1-to-1 exchange and I have to direct my concern to the "sales" team, which is the retail shop which I bought my netbook from.	service center	negative
It was not clear that the Microsoft Student Edition that was loaded on the computer, was a six month trial.	Microsoft Student Edition	negative
The computer continued to give me issues and in Late June it completely died again and I tried to call Acer again to get it fixed and they refused to help me, they said my warrenty was up and hung up on me.	warrenty	negative
Bigger HD, better graphics card, and a bid HD.	graphics card	positive
It is VERY easy to type on and feels great - besides the added feature that the keyboard is lighted.	type	positive
The "abuse" is that I pushed the power plug in too hard.	power plug	negative
My kids (and dogs) destroyed two power cords by pulling on them.	power cords	neutral
I can have both OSX and Windows XP running at the same time!	OSX	positive
  We have had numerous problems with Vista, such as Adobe Flash player just quits and has to be uninstalled and then reinsalled, Internet Explore just quits and you lose whatever you were working on, also, the same Windows update has appeared on this computer since we got it and has been updated probably 400 times, the same update.	Internet Explore	negative
  i have tried to charge on different batteries with no luck.	batteries	negative
Mac also has many apps and programs that are quite cheap or free.	programs	positive
The downside to this netbook is pretty much the same for any netbook: screen size is not something I'd stare at for the entire 10-11 hours of battery life five days a week.	battery life	neutral
Battery life could be better but overall for the price and Toshiba's reputation for laptops it's great!	price	positive
I love the multi-touch trackpad.	multi-touch trackpad	positive
-Touchpad will take a bit of time to get used to.	Touchpad	neutral
With what I do know how to do, the computer works beautiful.	works	positive
in 5 months the connect quality got worse and worse.	connect quality	negative
The computer loads in about a 1/10th of the time that my PC did, and I have all of the programs that were on my PC.	loads	positive
Best thing is I can use existing 32 bit old programs.	programs	positive
Apparently well-built and gorgeous to look at, the i5 MacBook Pro is a winning combination of price and performance.	price	positive
It's so much easier to navigate through the operating system, to find files, and it runs a lot faster!	runs	positive
The screen resolution was exactly what I was looking for.	screen resolution	positive
Size: I know 13 is small (especially for a desktop replacement) but with an external monitor, who cares.	external monitor	neutral
BEST BUY - 5 STARS + + + (sales, service, respect for old men who aren't familiar with the technology) DELL COMPUTERS - 3 stars DELL SUPPORT - owes a me a couple	sales	positive
However, I love this particular Mac because its very fast, great size, and has fantastic features like the lighted keyboard and easy mouse pad.	size	positive
WIth the upgraded memory, the MacBook Pro never has an issue running many many applications at once!	upgraded memory	positive
I also love the small, convenient size of my laptop, making it a perfect tool for my academic studies.	size	positive
It took several weeks just to get them to acknowledge that I owned the warranty.	warranty	negative
Only issue is that it is a little slow, and I'm fixing that by adding more RAM.	RAM	neutral
I also purchased iWork to go with it which has programs for word processing, spreadsheets, and presentations (similar to Microsoft Office).	iWork	neutral
Now I have the best of both worlds with all of the power and ease of the Mac!	ease	positive
The dv4 boasted a faster processor, more memory, and a bigger hard drive than my old computer, plus a better quality web cam, nicer screen, and many other features.	screen	positive
So I called customer support (which is good too) and they went through it and it is just a safety feature and it does not affect performance at all, I just chose to hide the message.	performance	neutral
A great computer for light home use and business use.	business use	positive
There are several programs for school or office use (Pages, Numbers, Keynote, etc.), music (Garageband), photo management (Photo Booth, iPhoto), video-editing or movie-making (iMovie), etc.	Keynote	neutral
Disappointing for such a lovely screen and at a reasonable price	screen	positive
The mousepad is a huge pain in the arse!	mousepad	negative
Oh yea, has no numeric pad on the side.	numeric pad	negative
no complaints with their desktop, and maybe because it just sits on your desktop, and you don't carry it around, which could jar the hard drive, or the motherboard.	hard drive	neutral
Mac is not made for gaming.	gaming	negative
It has plenty of memory, lots of hard drive, and great graphics.	hard drive	positive
They break down just as often as PCs do, and the only reason they don't get viruses, is because no one makes viruses for them, they're not better in any way, they are worse, try finding virus protection programs for a Mac, they don't exist.	virus protection programs for a Mac	negative
The macbooks are small enough to be very portable yet hold tons of information and performance.	performance	positive
The programs are great, like iphoto (love the editing capabilities), imail (which can incorporate with the address book on the ipod and ipad), imovie, etc.	programs	positive
It has all the features that are necessary for college and if not they are able to be added onto the computer.	features	positive
The OS is still as fast as the day that the laptop was purchased and continues to run flawlessly.	OS	positive
the screen brightness automatically adjusts.	screen brightness	neutral
Plain and simple, it(laptop) runs great and loads fast.	runs	positive
Temperatures on the outside were alright but i did not track in Core Processing Unit temperatures.	Core Processing Unit temperatures	neutral
Needs Power and Mouse Cable to Plug in back instead of side, In the way of operating a mouse in small area.	mouse	negative
But after using it a couple of weeks, the overall operation is poor.	operation	negative
-When battery life went to 4 hours or less, took it to the MacHouse Amsterdam for repair (26th of August).	battery life	negative
I wanted something that had a new Intel Core processors and HDMI port so that we could hook it up directly to our TV.	HDMI port	neutral
It was slow, locked up, and also had hardware replaced after only 2 months!	hardware	negative
It was a great laptop, ran great and was really fast.	ran	positive
I think part of the problem with this computer is Vista, yet I know Vista isn't the entire issue because my latest purchase was my Acer and it also has Vista (I should have waited the few months to get the next operating system).	operating system	neutral
iPhotos is an excellent program for storing and organizing photos.	iPhotos	positive
My real problem with it? The statement of 7 hour battery life is not just mere exaggeration -- it's a lie.	battery life	negative
Screen size is perfect for portable use in any environment.	Screen size	positive
I have found it very easy to use, very imformative, wonder alerts and tutorials making it very easy for someone like me who is not exactly technologically advanced to learn to use the various features and programs.	features	positive
But to be honest, I don't use my computer for anything like graphics editing and complex data analysis and gaming.	graphics editing	neutral
The Mac Snow Leopard O/S is extremely easy to use, although very different than Win XP, Visa or Win7.	Visa	neutral
/ awesome cooling system/ much better grafics card (ATI 5870) / 8GB RAM/ LED backlit screen...	grafics card	positive
There is no need to purchase virus protection for Mac, which saves me a lot of time and money.	virus protection for Mac	positive
Since I've had this computer I've only used the trackpad because it is so nice and smooth.	trackpad	positive
I have Vista, so I am unable to install and uninstall  some programs.	Vista	negative
Boots up fast and runs great!	Boots up	positive
The computer runs very fast with no problems and the iLife software that comes with it (iPhoto, iMovie, iWeb, iTunes, GarageBand) is all very helpful as well.	iMovie	positive
It is absolutely horrible to use, despite all its so called advanced features.	use	negative
That included the extra Sony Sonic Stage software, the speakers and the subwoofer I got (that WAS worth the money), the bluetooth mouse for my supposedly bluetooth enabled computer, the extended life battery and the Docking port.	Docking port	neutral
I play a lot of casual games online, and the touchpad is very responsive.	touchpad	positive
Size: I know 13 is small (especially for a desktop replacement) but with an external monitor, who cares.	Size	negative
I always have used a tower home PC and jumped to the laptop and have been very satisfied with its performance.	performance	positive
My MacBook Pro works like a dream, it has never overheated, or even been slightly warm for that matter.	works	positive
When I got my laptop back after this first instance it worked okay for a little bit then I started expeirencing issues again, everything from programs and drivers failing again, to it powering off for no reason, to locking up and freezing and just all sorts of issues.	programs	negative
(No problem with the ordering or shipping by the way.	shipping	positive
I picked it out because it was inexpensive ($400) and I thought it would be a good, easy to use first laptop.	use	positive
The internet capabilities are also very strong and picks up signals very easily.	internet capabilities	positive
Laptop is advertised as a 15" but the casing looks like that of a 17".	15"	neutral
See when it comes to laptops you buy it and get just a normal operating system with trials of must need stuff that should come with it.	operating system	neutral
I finally decided on this laptop because it was the right price for what I need it.	price	positive
But guess what?  (you have to buy an external dvd drive it doesn't have a built in type) The notebook can't be used because it doesn't read anything for an external drive.	external dvd drive	negative
they improved nothing else such as Resolution, appearance, cooling system, graphics card, etc.	Resolution	negative
Graphics are clean and sharp, internet interfaces are seamless.	Graphics	positive
EITHER WAY, THE KEYBOARD IS UNSATISFACTORY.	KEYBOARD	negative
My daughter uses it for games, email, facebook, pictures and music.	games	neutral
after much effort and 10 days ASUS replaced itThe WiFi is very weak.	WiFi	negative
Screen is crystal clear and the system is very responsive.	Screen	positive
It fires up in the morning in less than 30 seconds and I have never had any issues with it freezing.	fires up	positive
My friend reports the notebook is astonishing in performance, picture quality, and ease of use.	picture quality	positive
I am not much of a computer techie, so I can understand some of the internal problems, though I do have trend micro as an antiviral program.	antiviral program	neutral
Startup in about 30 seconds, shutdown in 2-4 seconds, resume from sleep in 0-2 seconds.	resume from sleep	neutral
There is nothing to complain about the system.	system	positive
As a computer science student in college, I find that the portability, longevity, and ease of use of this computer make me (shockingly) want to do homework more;	longevity	positive
Windows XP SP2 caused many problems on the computer, so I had to remove it.	Windows XP SP2	negative
I believe that the quality of a mac is worth the price.	quality	positive
Even so, I like playing online games, so it was wonderful that there is a feature where I can dualboot Windows.	feature	positive
We love the size of the screen, although it is still lightweight and very easy to tote around.	tote	positive
From the build quality to the performance, everything about it has been sub-par from what I would have expected from Apple.	build quality	negative
The price is another driving influence that made me purchase this laptop.	price	positive
Love the stability of the Mac software and operating system.	Mac software	positive
I chose the iBookG4, a laptop that is an attractive computer with a large screen big enough to please anyone.	screen	positive
The brand is tarnished in my heart.	brand	negative
It has a faster processor and more ram.	ram	positive
Treat yourself to a more expensive, long-lasting laptop of quality like a Sony, Apple, or Toshiba.	quality	positive
Overall : Poor, Features: Average, Performance: Poor, Battery Life: Excellent, Price-Value: Poor	Battery Life	positive
) I also tried the touch pad and compared it to other netbooks in the store.	touch pad	neutral
Overall : Poor, Features: Average, Performance: Poor, Battery Life: Excellent, Price-Value: Poor	Price	negative
I cannot be happier with the service or product.	service	positive
Comfterbale to use light easy to transport.	transport	positive
They should have included more memory on their computers if they knew Vista would run slowly.	memory	negative
The cover for the DVD drive soon came off, too--a mark of poor construction quality.	cover for the DVD drive	negative
This is great if you have several lectures back to back and don't have a chance to charge during one of the lectures.	charge	positive
 I actually had the hard drive replaced twice, the mother board once, the dvd drive twice, then they FINALLY agreed to replace it, (ALL OF THIS IN LESS THAN 1 1/2 YEARS!	hard drive	negative
This MacBook is an outstanding product with great value.	value	positive
That included the extra Sony Sonic Stage software, the speakers and the subwoofer I got (that WAS worth the money), the bluetooth mouse for my supposedly bluetooth enabled computer, the extended life battery and the Docking port.	subwoofer	positive
I run windows via bootcamp for the couple programs I do not want to buy a mac version of, like my cad programs.	programs	neutral
Then, within 5 months, the charger crapped out on me.	charger	negative
Features such as the Dashboard (allows you to view frequently used tools like a calculator, weather forecast, movie times, calendar, computer post its etc.	Features	neutral
There are no viruses or spyware to worry about like on a Windows computer.	Windows	negative
The built in camera is very useful when chatting with other techs in remote buildings on our campus.	built in camera	positive
In fact, somehow (and I never opened it up) some specks of dust or something got inside the screen and are now there permanently, behind the front of the screen, in the way of the display.	display	negative
The shop will definitely push the problem to the service center.	service center	neutral
Drivers updated ok but the BIOS update froze the system up and the computer shut down.	system	negative
The program came with the computer and works beautifully.	program	positive
I would rate this computer at 5 stars, but considering it has a short life span I can only give it 1 and implore anyone looking at laptops to stay away from this machine.	life span	negative
It does not even have the software to play a dvd now.	software	negative
The only bad part is the size/weight.	size	negative
I was taught to use Photoshop and was amazed.	Photoshop	positive
  Again I sent it back and they replaced the motherboard and some fan inside.	motherboard	neutral
Processor - When compared to my 3 week old Early 2011 edition there I barely experience any difference in performance (2.3 GHz v/s 2.4 GHz).	Processor	neutral
There are several programs for school or office use (Pages, Numbers, Keynote, etc.), music (Garageband), photo management (Photo Booth, iPhoto), video-editing or movie-making (iMovie), etc.	music	neutral
great battery life.	battery life	positive
The most recent being that my Safari internet browser is freaking out on me, but I have just been using firefox instead.	Safari internet browser	negative
The acer one computer that I bought is 17 ince screen and its hard to find lap top bags for it, but I like the big screen on it.	17 ince screen	neutral
It is fast booting up , shutting down, and connection with the internet.	shutting down	positive
So then you may be lucky to get ahold to someone who understands that its no good and they will let you send it back, but of course you are taking a chance of them testing it out to see what has happened, and they tell you that it was not on their side , then you are stuck paying for the repair (the price of a new one).	price	negative
you can find many laptops with the same performance and even better with lower price, but you cannot find the look, easy, applications, and the experience in mac.	applications	positive
The dv4 boasted a faster processor, more memory, and a bigger hard drive than my old computer, plus a better quality web cam, nicer screen, and many other features.	memory	positive
The Aspire wont even boot past the Acer screen with a Droid (I have tried both Motorola and HTC) plugged into the USB port.	USB port	negative
The only thing that isn't perfect about this netbook is the speakers, they are not loud at all but I expected that.	speakers	negative
Besides the great look, it is a great machine.	look	positive
  This time the mouse pad and right click key wouldn't work!	mouse pad	negative
while the keyboard itself is alright, the plate around it is cheap plastic and makes a hollow sound when using the mouse command buttons.	plate	negative
The only downfall is the volume control.	volume control	negative
Obviously one of the most important features of any computer is the "human interface.	human interface	neutral
It is super easy to use.	use	positive
This wiped out several programs that were installed on the computer when it was bought.	programs	negative
The battery never held a charge longer than one hour and within two months, stopped holding a charge for more than ten minutes.	battery	negative
The graphics were awful and the warranty isn't even worth the cheap payment on the computer.	warranty	negative
Great Laptop for the price, works well with action pack games.	works	positive
Learning all of the keyboard shortcuts only took a few minutes to get used to as some of the shortcuts are the same on Windows machines.	shortcuts	neutral
Wonderful sleek case design is only on the outside.	case design	positive
I made a photo book as a gift, on my computer, pushed "Buy" and it drew from my iTunes account and sent the book to my house, the book was of perfect quality-exactly how I had created it and looked better than I had even imagined.	iTunes	neutral
The screen is very large and crystal clear with amazing colors and resolution.	resolution	positive
The port is secured to motherboard so when this  happens you can't see the plug at all, it's just gone.	plug	negative
They said that my computer was covered on an extended warranty, and that products with  extended warranties are taken care of through third parties and not Sony itself anymore.	extended warranties	neutral
The technical service for dell is so 3rd world it might as well not even bother.	technical service for dell	negative
(I had been a Windows/Linux user before this) I love the size because the screen is big enough for what I use it for (Internet, artwork), and yet it is small enough to be reasonably portable.	Windows	neutral
After sending out documents via email and having recipients tell me they could not open the documents or they came through as gibberish, I broke down and spent another $100 to get Microsoft Word for Mac.	Microsoft Word for Mac	neutral
Peformance is good for the price.	Peformance	positive
The price and features more than met my needs.	features	positive
I was looking too closely at the other performance specs and while comparing, I took it for granted that these features were standard.	performance specs	neutral
My dad has one of the very first Toshibas ever made, yes its abit slow now but still works well and i hooked to my ethernet!	works	positive
The feature are good enough for what I need.	feature	positive
Overall : Poor, Features: Average, Performance: Poor, Battery Life: Excellent, Price-Value: Poor	Value	negative
I'ts nice to have the higher-end laptops, but this fits my budget and the features I need.	budget	positive
But the screen size is not that bad for email and web browsing.	screen size	positive
I love the solid machined aluminum frame, and the keyboard is the best of any laptop I've used.	keyboard	positive
Great laptop that offers many great features!	features	positive
  I definitely suggest getting an extended warranty, you will probably need it!	extended warranty	positive
With all the programs that came with it, such as iLife and iWork, I was set from the very beginning.	iLife	neutral
The price was very good, and the product is top quality.	price	positive
I had upgraded my old MacBook to Lion, so I kind of knew what I was getting, but hadn't been able to enjoy some of the awesome new multi-touch features.	multi-touch features	positive
A longer battery life would have been great - but it meets it's spec quite easily.	spec	positive
  Now, as easy as it is to use, and I do think it is a great STARTER laptop.	use	positive
and it comes with the new OSX that comes with new features that makes the use more easy.	OSX	positive
Love that it doesn't take up space like a regular computer.	space	positive
If you're looking for something to fly through those massive spreadsheets or play a graphics-intensive game, you'd be better off getting a machine aimed at that segment of the market.	game	neutral
If you don't feel comfortable doing it yourself, just buy the case and be happy, plus it looks nice, I bought the white one from Best Buy.	case	positive
Pay attention to the specs if you want these options.	specs	neutral
I love the easy to see screen, and It works well for work, persoal or just play.	works	positive
It's still beautiful and has better color reproduction than I could ever expect from a notebook.	color reproduction	positive
I just plug this into my 22" Monitor and the speedy MacOSX performs just as well on this dual-core that my Dell did with Windows 7 with a quad-core.	quad-core	neutral
I am using the external speaker- sound is good.	external speaker	positive
Even so, I like playing online games, so it was wonderful that there is a feature where I can dualboot Windows.	games	neutral
It is everything I'd hoped it would be from a look and feel standpoint, but somehow a bit more sturdy.	look and feel standpoint	positive
Unless you need the Bluetooth 3.	Bluetooth 3	neutral
pretty much everything else about the computer is good it just stops working out of no were.	working	negative
While most people say that PCs hold functionality and value and Macs are just pretty to look at, I think there's something to be said about the simplicity of Macs.	look	positive
Of course, for a student, weight is always an issue.	weight	neutral
I dual boot with Linux and that other security-prone OS and it performs flawlessly.	performs	positive
I know there are way better laptops out there for the same price, and why spend money on shit when you can go out and get yourself a perfectly decent laptop that doesnt suck total monkey balls.	price	neutral
I am first time Mac Buyer and am amazed at features and ease of use the Mac offers.	features	positive
The keyboard is slick and quiet and not bulky like some other laptops I have had in the past.	keyboard	positive
They said that my computer was covered on an extended warranty, and that products with  extended warranties are taken care of through third parties and not Sony itself anymore.	extended warranty	neutral
 I actually had the hard drive replaced twice, the mother board once, the dvd drive twice, then they FINALLY agreed to replace it, (ALL OF THIS IN LESS THAN 1 1/2 YEARS!	mother board	negative
The Macbook is also made better, my computer has never got a virus, and the laptop runs just as fast as the first day I bought it.	runs	positive
I paid for extra memory and the 17-inch screen, as well as the top of the line DVD and CD burners.	DVD	positive
OS X is solid with lots of innovations such as quicklook which save heaps of time.	quicklook	positive
It is easy to go from one keyboard to another.	keyboard	neutral
It's so much easier to navigate through the operating system, to find files, and it runs a lot faster!	find files	positive
I took 3-4 years researching brands and prices of laptops.	prices	neutral
Also, I issued a replacement RMA for a few dead pixels in the upper zone of the screen, which is noticable to me.	screen	negative
(If you ever see the spinning beachball come up when you think it shouldn't, check the "Activity Monitor" app to see if the disk throughput has temporarily dropped to zero.	spinning beachball	negative
I use this for my tutoring business, and since I'm always bouncing from student to student, it is ideal for portability and battery life (yes, it gets the 8 hours as advertised!).	portability	positive
I have found also, it is very easy to be able to access wireless internet access;	wireless internet access	positive
I have Vista, so I am unable to install and uninstall  some programs.	programs	negative
They offer the best warranty in the business, and don't 3rd party it out like Toshiba.	warranty	positive
From the build quality to the performance, everything about it has been sub-par from what I would have expected from Apple.	performance	negative
The machine has a bluray player the book has no mention of it or how to connect it to your HDTV.	book	negative
  Until I bought the Dell, I thought you just looked for what you wanted (size, software, options, hardware) and purchase the best deal you could find.	hardware	neutral
So what am I supposed to do?  The LG service center cannot provide me the "service" when it is called the "service center".	service center	negative
Second HDD cover has walls inside that need to be broken if you what to install one.	HDD cover	neutral
Graphics are clean and sharp, internet interfaces are seamless.	internet interfaces	positive
The sheer power and flexibility makes the MacBook Pro a must have for any techie!	power	positive
Granted, it's still a very new laptop but in comparison to my previous laptops and desktops, my Mac boots up noticeably quicker.	boots up	positive
Runs fast and the regular layout keyboard is so much better.	regular layout keyboard	positive
This is likely due to poor grounding and isolation between the components, and I'm hoping that it can be fixed with a ground loop isolator, but I still expected better product quality for this price range.	price range	negative
Yes, a Mac is much more money than the average laptop out there, but there is no comparison in style, speed and just cool factor.	speed	positive
I run windows via bootcamp for the couple programs I do not want to buy a mac version of, like my cad programs.	windows	neutral
A seventy dollar mouse!	mouse	neutral
I was looking too closely at the other performance specs and while comparing, I took it for granted that these features were standard.	features	neutral
Setting would change for some reason, the screen size would change on it's own, like the pixel sizes and whatnot.	pixel sizes	negative
I also enjoy the fact that my MacBook Pro laptop allows me to run Windows 7 on it by using the VMWare program.	VMWare program	neutral
I thought learning the Mac OS would be hard, but it is easily picked up if you are familiar with a PC.	Mac OS	positive
I had something else go wrong and they said it had to be in good working order to be able to buy the warranty.	warranty	negative
Yes, I thought the expese was a little much, but I now realize you get what you pay for.	expese	negative
Info: Windows failed to load because the kernal is missing, or corrupt.	kernal	negative
My one complaint with this laptop is that I've noticed an electronic fuzz sound coming out of the headphone jack when headphones are plugged in.	headphone jack	negative
Navigation through the computer is far superior compared to Windows operating systems, as well.	Windows operating systems	negative
I am most impressed with the programming, including the iPhoto.	iPhoto	positive
Took several hours with customer support before I could even start the PC out of the box.	customer support	negative
But the machine is awesome and iLife is great and I love Snow Leopard X.	iLife	positive
For me I was lucky and a local store was selling them for $2000 off and Best Buy matched their price so I was able to buy one for under $1000	price	positive
Not sure how I recommend it for quality gaming, as I have a desktop rig for that reason.	gaming	negative
Came fully loaded - good.	loaded	positive
Some problems can be fixed if you purchase new software, but there is no guarentee.	software	negative
Well I spilled something on it and they replaced it with this model, which gets hot and the battery doesn't make it through 1 DVD.	battery	negative
Waiting for the i7 was well worth it, great value for the price.	price	positive
I don't have stupid pop up windows (even when I have pop ups blocked), I don't have to wait 5 minutes for a webpage to download, and best of all I can run all the web programming software I need to use all at once without slowing me down.	pop ups	neutral
The touchpad is very intuitive, so much so that I never want to use buttons to click again!	touchpad	positive
Yes, a Mac is much more money than the average laptop out there, but there is no comparison in style, speed and just cool factor.	style	positive
Hard disk - The new editions gives you more hard disk space (500GB instead of 320GB) but time has taught me never to trust an internal hard disk.	Hard disk	neutral
It is not ideal for children because of the temp.	temp	negative
The backlit keys are wonderful when you are working in the dark.	backlit keys	positive
Not too much "junk" software to remove.	software	positive
They say that this will invalidate the warranty on the hard drive (I don't really understand why but anyway).	hard drive	neutral
Fan vents to the side, so no cooling pad needed, great feature!	cooling pad	neutral
Whenever tried to turn it on, it would restart as soon as the BIOS launched Windows (or Winblows, as I like ot call it).	BIOS	negative
I use iphoto all the time, which is a great program for anyone who is into photography - amateurs and experts alike.	program	positive
I bought it for my mom and she reports that the battery life lasts all day for her, it's very lightweight, and the response for the computing she's doing (Internet focused activity: mail, research, etc.) is excellent;	response	positive
The apple care has never failed me, and I expect it to be the same for this computer as well.	apple care	positive
I was disappointed when I realized that the keyboard doesn't light up on this model.	keyboard	negative
There is hardly any memory on the computer's hard drive.	hard drive	negative
The PhotoBooth is a great program, it takes very good pictures with the built-in camera.	PhotoBooth	positive
I saw walmart had the same computer for about $650 but still knowing what I know now,I would not buy it at that price.	price	negative
It was hard to handle and operate at school.	operate	negative
But, for the cost this is a winner.	cost	positive
I also like that you can scroll down in a window using two fingers on the trackpad.	trackpad	positive
We paid for the three year warranty and the extended warranty after that one ended as well.	extended warranty	neutral
HP is more interested in selling extended warranties (which cost more than the netbook new) then they are in helping or fixing.	extended warranties	negative
Ever since I bought this laptop, so far I've experience nothing but constant break downs of the laptop and bad customer services I received over the phone with toshiba customer services hotlines.	customer services	negative
The computer runs very fast with no problems and the iLife software that comes with it (iPhoto, iMovie, iWeb, iTunes, GarageBand) is all very helpful as well.	GarageBand	positive
Suffice it to say, my MacBook Pro keeps me going with its long battery life and blazing speed.	battery life	positive
This computer had exactly the specifications I needed.	specifications	positive
I used to build my own desktops from the component parts, and recently my 7 year old Pentium 4 with HT 1 GB ram SATA desktop stopped working (this was a rock star 7 years ago).	1 GB ram	neutral
It has easy to use features and all the speed and power I could ask for.	power	positive
Aside from the trial software and the short battery life, lack of a webcam, its great.	trial software	negative
The OS takes some getting used to especially after being a Windows user for so long but the learning curve is so worth it!	Windows	neutral
The 2 GB of RAM is plenty, able to run Windows 7 and at least 2 or 3 other programs with next to no slowdown.	Windows 7	positive
The Apple applications (ex.iPhoto) are fun, easy, and really cool to use (unlike the competition)!	Apple applications	positive
I will never go back to Windows!	Windows	negative
Once open, the leading edge is razor sharp.	leading edge	negative
(The SATA controller is the motherboard chip that lets the CPU talk to the hard drive.)	SATA controller	neutral
Applications open in seconds and there are no lags, hiccups or awkward moments when you wonder whether your computer is out for tea.	Applications	positive
Runs fast and the regular layout keyboard is so much better.	Runs	positive
Have had many higher priced computers crash and burn long before ever got to use all that great memory and speed, etc.	speed	negative
The brand of iTunes has just become ingrained in our lexicon now, but keep in mind that Apple started it all.	iTunes	positive
There is a small red circle next to it with a x in the middle, and when I click on it it says: " Consider replacing your battery" and it does not hold full charge.	battery	neutral
The most recent being that my Safari internet browser is freaking out on me, but I have just been using firefox instead.	firefox	positive
I'm still within the one year warranty but the repair "depot"  has deemed that this time it was caused by physical abuse and is not  covered.	repair "depot"	negative
-Computer crashed frequently and battery life decreased very quickly.	battery life	negative
A SECOND PROBLEM INVOLVES THE BATTERY WHICH IS ADVERTISED AS HAVING A STORAGE LIFE OF 11 HOURS BUT WHEN FULLY CHARGED SHOWS ONLY 7 HOURS OF SERVICE.	BATTERY	negative
Typing on the keyboard becomes uncomfortable after extended use due to the sharp edges that your wrists rest on.	keyboard	negative
  Toshiba is aware of the issue but unless the extended warrenty is bought Toshiba will do nothing about it.	extended warrenty	negative
I need graphic power to run my Adobe Creative apps efficiently.	Adobe Creative apps	neutral
Web access through the 3G network is so slow, it's very frustrating and VERY DISAPPOINTING.	3G network	negative
  The only thing I can imagine is that Sony jumped on early specifications for Vista requirements from Microsoft and designed it to those inadequate requirements.	Vista	negative
I love the dock where I can simply drop a file ontop of a particular program, and the program will simply open that file.	dock	positive
If what you need is a machine to do some surfing, email checking, word processing, and watching a movie or two, this is the machine you want.	word processing	neutral
AND the best part is that it even comes with a free printer (when they have a certain promotion/offer going, of course)!	printer	positive
The paint wears off easily due to the keyboard being farther back than usual.	keyboard	negative
I also purchased Office Max's "Max Assurance" with the "no lemon" clause.	Office Max's "Max Assurance"	neutral
the programs are esay to use and are quick to process this computer works like a charm.	programs	positive
  Again I sent it back and they replaced the motherboard and some fan inside.	fan	neutral
It is speedy when connected wirelessly to any network regardless if the connection is weak or not.	connection	neutral
Also the speakers are not very loud, But it is a netbook.	speakers	negative
(The SATA controller is the motherboard chip that lets the CPU talk to the hard drive.)	hard drive	neutral
While it was highly rated, would I like it? I tried the keyboard at the store, and it seemed ok.	keyboard	neutral
The processor a AMD Semprom at 2.1 ghz is a bummer it does not have the power for HD or heavy computing.	processor	negative
Even though it is running Snow Leopard, 2.4 GHz C2D is a bit of an antiquated CPU and thus the occasional spinning wheel would appear when running Office Mac applications such as Word or Excel.	CPU	negative
  I actually contact Toshiba before I started having problem and was given run around after I supplied serial number in order to delay me sending in laptop until after warrenty expired.	warrenty	negative
I also purchased iWork to go with it which has programs for word processing, spreadsheets, and presentations (similar to Microsoft Office).	programs	neutral
It rarely works and when it does it's incredibly slow.	works	negative
I looked around and based off my price/features comparison from a brand I trusted I landed here.	features	neutral
Purchased a Toshiba Lap top it worked good until just after the warrenty went out.	warrenty	negative
I got assurances from 2 different people that the remaining 10 months of my warranty would transfer to the new computer.	warranty	positive
I was said it's videocard.	videocard	negative
Being a PC user my whole life, it's taking a bit of time to adapt to the OS of a Mac but I'm finding my way around.	OS	neutral
So what am I supposed to do?  The LG service center cannot provide me the "service" when it is called the "service center".	LG service center	negative
also it comes with very useful applications like iphoto that it is the best photo application i have ever had	photo application	positive
Every driver on the drivers/applications DVD is everything you will need for a reload.	driver	positive
  After the warrenty expired the hard drive went bad and it would have cost more to fix then to replace.	hard drive	negative
They should have included more memory on their computers if they knew Vista would run slowly.	Vista	negative
Its Office compatible, but the features and its functioning is all new again so you might as well save the money and just learn the pre installed mac programs.	functioning	neutral
the hinge design forced you to place various connections all around the computer, left right and front.	hinge design	negative
Needs longer lasting battery, More than 1 to 2 Hrs.	battery	negative
Most everything is fine with this machine: speed, capacity, build.	capacity	positive
Additional caveat: the base installation comes with some Toshiba-specific software that may or may not be to a user's liking.	software	negative
My wireless system would not recognize Windows 7 and I couldn't get online to find out why.	Windows 7	neutral
I got it back and my built-in webcam and built-in mic were shorting out anytime I touched the lid, (mind you this was my means of communication with my fiance who was deployed) but I suffered thru it and would constandly have to reset the computer to be able to use my cam and mic anytime they went out.	built-in webcam	negative
it has 3 usb ports, 1 sd memory card reader and an sd memory car expansion.	sd memory card reader	neutral
The laptop is outstanding in all aspects except that it has the Windows 7 starter and not the full Windows 7.	Windows 7 starter	negative
My power supply cord developed exposed wires within the first year of ownership, so it was covered by the Applecare warranty plan.	Applecare warranty plan	positive
Also, if you need to talk to a representive at Microsoft, there is a charge, which I believe is robbery, since you are charged enormous amounts for a very badly designed system, which most people would have went with XP if they could.	XP	positive
It is short on space, and downloads always had problems being completed, or were said to be 'corrupted'.	space	negative
So what if the laptops/mobile phones look chic and cool? The after sales support is terrible.	after sales support	negative
Windows Vista makes this computer almost unusable for online service.	online service	negative
But you must get the 15 inch.	15 inch	positive
The internet was locekd and froze every time it was trying to be used, and the command prompt would not work at all.	internet	negative
PC users use the Powerpoint program for slide-show presentation and Mac users utilize Keynote.	Keynote	neutral
  I could not find a phone number anywhere to call an actual live person for tech support and had to result the their online chat.	online chat	neutral
There are several programs for school or office use (Pages, Numbers, Keynote, etc.), music (Garageband), photo management (Photo Booth, iPhoto), video-editing or movie-making (iMovie), etc.	Numbers	neutral
It was still working, but there was nothing on the screen.	screen	negative
Great OS, fabulous improvements to the existing line bumping up the processor speed and adding the thunderbolt port.	thunderbolt port	positive
the headphone and mic jack are in front of touch-pad making the touch-pad hard to use when using headphones/mic, not to mention the laptop was designed for right handed person.	headphones	negative
and it comes with the new OSX that comes with new features that makes the use more easy.	use	positive
  Another THREE weeks later I had my laptop back with a new mousepad, keys, and casing.	mousepad	neutral
This is a nicely sized laptop with lots of processing power and long battery life.	battery life	positive
First things first, Macbook pro has many applications to make life easier, unlike the windows computers.	windows	negative
Still under warrenty so called Toshiba, no help at all.	warrenty	negative
I even got my teenage son one, because of the features that it offers, like, iChat, Photobooth, garage band and more!	features	positive
Its ease of use and the top service from Apple- be it their phone assistance or bellying up to the genius bar- cannot be beat.	genius bar	positive
For the not so good, I got the stock screen - which is VERY glossy.	stock screen	negative
 One night I turned the freaking thing off after using it, the next day I turn it on, no GUI, screen all dark, power light steady, hard drive light steady and not flashing as it usually does.	power light	neutral
The Nortons virus scan is only for a very short time unlike others that usually are good for a year.	Nortons virus scan	negative
Aside from the trial software and the short battery life, lack of a webcam, its great.	webcam	negative
The first full charge of this battery got me only about 2 full hours.	full charge	negative
I've been impressed with the battery life and the performance for such a small amount of memory.	memory	negative
  It was loaded with Windows Vista Home Premium--delivered with only 1GB of RAM, and it was a *dog*.	1GB of RAM	negative
Love the graphics, awesome programs (including Garageband), and really cool default background.	Garageband	positive
The speakers on it are useless too.	speakers	negative
I had to re-install Windows within two weeks of the purchase and soon discovered cracks in the screen hinges.	Windows	negative
It is very well built.	built	positive
I bought a Logitech desktop set in anticipation for using with the MBP, but I use the touchpad 90% of the time.	touchpad	positive
After numerous attempts of trying (including setting the clock in BIOS setup directly), I gave up(I am a techie).	clock in BIOS setup	negative
I gave it to my daughter because I just hated the screen, hated that it had no cd drive to at least play cd's when I wanted to listen to music and do schoolwork.	cd drive	negative
The people are frustrating to work with, the product itself is very cheaply made, and the accessories are less than satisfactory.	accessories	negative
Typing on the keyboard becomes uncomfortable after extended use due to the sharp edges that your wrists rest on.	edges	negative
I am using the external speaker- sound is good.	sound	positive
The battery life is amazing, the versitility is outstanding.	battery life	positive
Call tech support, standard email the form and fax it back in to us.	tech support	neutral
-4 RAM slots, 2 HDD Bays*, 16GB RAM support -No Wireless Issues, at least for me.	HDD Bays	neutral
I had my IWORKS, Itunes, Email, MS Office, network and printers set up and completely working perfectly within an hour.	MS Office	positive
The ease of set up was terrific.	set up	positive
The computer loads in about a 1/10th of the time that my PC did, and I have all of the programs that were on my PC.	programs	positive
my niece and nephew have played a few web games and it runs anything that doesn't require a dedicated video card.	video card	neutral
The programs are great, like iphoto (love the editing capabilities), imail (which can incorporate with the address book on the ipod and ipad), imovie, etc.	iphoto	positive
) And printing from either word processor is an adventure.	word processor	negative
In due course, I'll remove the hard disc from this new MacBook Pro and dump it where it belongs - in the trash.	hard disc	negative
But sitting on a lap or on a desk in front of you it looks more than big enough (this could be because Im used to my Lenovo 10 tablet now) plus this is a great size if I want to unplug the external keyboard, mouse, and monitor to take it with me when I take photos and video.	mouse	neutral
It's so nice to look at and the keys are easy to type with.	look	positive
In desparation, I called their Customer Service number and was told that my warranty had expired (2 days old) and that the priviledge of talking to a technician would cost me ("have your credit card ready").	talking to a technician	negative
We use the built in tools often, iTunes is open nearly every day and works great with my iPhone.	built in tools	neutral
Even though it is running Snow Leopard, 2.4 GHz C2D is a bit of an antiquated CPU and thus the occasional spinning wheel would appear when running Office Mac applications such as Word or Excel.	Word	negative
The ease of use is wonderful.	use	positive
My power supply cord developed exposed wires within the first year of ownership, so it was covered by the Applecare warranty plan.	power supply cord	negative
And if you do a lot of writing, editing is a problem since there is no  forward delete  key.	editing	negative
It is fast booting up , shutting down, and connection with the internet.	booting up	positive
Screen is awesome, battery life is good.	Screen	positive
In the shop, these MacBooks are encased in a soft rubber enclosure - so you will never know about the razor edge until you buy it, get it home, break the seal and use it (very clever con).	edge	negative
It didn't take me long to get switched over to the Mac computer programs and navigation - it's been just fine and like the way this laptop functions much better.	programs	positive
I also like the acer arcade but these were reallythe only two things I liked about this laptop.	acer arcade	positive
The Mac Snow Leopard O/S is extremely easy to use, although very different than Win XP, Visa or Win7.	Win XP	neutral
It has far exceeded my expectations for power, storage, and abilitiy.	abilitiy	positive
I'm still within the one year warranty but the repair "depot"  has deemed that this time it was caused by physical abuse and is not  covered.	warranty	negative
I'm really impressed with the quality and performance for the price of the computer.	price	positive
With the macbook pro it comes with freesecuritysoftware to protect it from viruses and other intrusive things from downloads and internet surfing or emails.	securitysoftware	positive
First, you ll discover that the word processing program known as  Appleworks  rarely translates perfectly on anyone else s computer, if it translates at all.	Appleworks	negative
Memory is upgradable.	Memory	positive
Laptop was in new condition and operational, but for the audio problem when 1st sent for repair.	audio	negative
Yeah, of course smarty pants "fix it now")Software - Compared to the early 2011 edition I did see inbuilt applications crashing and it prompted me to send the report to Apple (which I promptly did).	inbuilt applications	negative
Three weeks after I bought the netbook, the screen quit working.	screen	negative
I know that everyone thinks Macs are overpriced and overrated, but once you get past the initial expense you'll find that they're worth every penny (besides, there's always the financing plan that Best Buy offers).	expense	negative
Moral of the story:-Do not buy anything from companies that do not respect their customers.	companies	negative
However, the multi-touch gestures and large tracking area make having an external mouse unnecessary (unless you're gaming).	gaming	neutral
Externally the keys on my keyboard are falling off, after a few uses the paint is rubbing off the button below the mouse pad and where the heals of my hands sit, and the screen has a terrible glare.	button below the mouse pad	negative
Did I mention everything about it, from size to weight to keyboard screams BULK?	size	negative
My sister has the same Mac as me and she is in a band and uses GarageBand to record and edit.	GarageBand	neutral
The graphics and screen are stunning and although I was a PC person, I was able to understand how to use a mac fairly quickly.	graphics	positive
I was sorly disapointed to discover that HP (what I thought was a reputable company) wouldn't honor the warrenty when the fan blade fell apart.	warrenty	negative
I will have to purchase Spy ware or Nortell for privacy protection.	Spy ware	neutral
Going to bring it to service today.	service	neutral
I like those programs better than Office and you can save your files to be completely compatible with the Office programs as well.	programs	positive
This just keeps having it's hard drive replaced!	hard drive	negative
WIth the upgraded memory, the MacBook Pro never has an issue running many many applications at once!	running	positive
It's also fairly easy to use the Operating System.	Operating System	positive
Learning all of the keyboard shortcuts only took a few minutes to get used to as some of the shortcuts are the same on Windows machines.	keyboard shortcuts	positive
The processor went on me, the fan went and the motherboard went.	fan	negative
With today's company fighting over marketshare, its a shame that ASUS can get away with the inept staff answering thephone.	staff	negative
lots of extra space but the keyboard is ridiculously small.	keyboard	negative
After way too many times sending the thing in for repairs (delivery service was slow, and without the laptop I had no access to the internet, and thus no way of tracking it to find out when I might hope to see my computer again), it finally kicked the bucket after just over 2 years.	delivery service	negative
The speed gives you the power to work on these projects seamlessly, and multiple at a time if you sowish.	speed	positive
My Toshiba did not have sound on everything, just certain things.	sound	negative
And the screen on this thing is absolutely amazing for high quality videos and movies and gaming.	gaming	positive
WHEN TYPING, LETTERS AND SPACES ARE FREQUENTLY OMITTED REQUIRING THE USER TO REDO MANY WORDS AND SENTENCES.	TYPING	negative
It's software and speed enable it to do amazing things.	speed	positive
Three, the mac book has advantages over pcs' with linux based os there is very 'few problems with system performance when it comes to a mac.	linux based os	negative
Asus facial recognition doesn't work and windows logon isn't either.	windows logon	negative
That's very possible, but since they don't make Windows XP drivers for the sound card in this machine, I was stuck until Windows 7 came out.	sound card	negative
I bought this notebook and only had it for 3 months If it is overload with updates the BOOT MGR.	BOOT MGR	neutral
Great wifi too.	wifi	positive
The screen graphics and clarity, and sharpness are great.	screen graphics	positive
I run Dreamweaver, Final Cut Pro 7, Photoshop, Safari, Firefox, MSN Messenger and a few other applications constantly at the same time.	Safari	neutral
As a user of a PC, I will will admit that the macBook Pro has a better running system in which I found myself "Getting the job done quicker.	running system	positive
This computer I used daily nice compact design.	design	positive
The battery life is amazing, the versitility is outstanding.	versitility	positive
I have not had a problem with the applications quitting or freezing.	applications	positive
But guess what?  (you have to buy an external dvd drive it doesn't have a built in type) The notebook can't be used because it doesn't read anything for an external drive.	external drive	negative
The Apple team also assists you very nicely when choosing which computer is right for you :)	Apple team	positive
Right size and weight for portability.	size	positive
If upgrade is possible to the full Windows 7, then I will truly be a very happy geek.	Windows 7	positive
the manufacturer's warranty only covers replacement/repair of parts.	warranty	negative
It was very easy to just pick up and use-- It did not take long to get used to the Mac OS.	Mac OS	positive
The gray color was a good choice.	gray color	positive
I dislike the weight and size, cubersome.	size	negative
I also love the design, the looks, the feel, and the my toshiba feature is wonderfull.	looks	positive
It is VERY easy to type on and feels great - besides the added feature that the keyboard is lighted.	feature	positive
We upgraded the memory to four gigabytes in order to take advantage of the performace increase in speed.	memory	neutral
There are several programs for school or office use (Pages, Numbers, Keynote, etc.), music (Garageband), photo management (Photo Booth, iPhoto), video-editing or movie-making (iMovie), etc.	programs	neutral
  The hard drive crashed as well, and I had to buy a new  power cord.	power cord	negative
The processor went on me, the fan went and the motherboard went.	processor	negative
I don't have stupid pop up windows (even when I have pop ups blocked), I don't have to wait 5 minutes for a webpage to download, and best of all I can run all the web programming software I need to use all at once without slowing me down.	web programming software	positive
I just plug this into my 22" Monitor and the speedy MacOSX performs just as well on this dual-core that my Dell did with Windows 7 with a quad-core.	dual-core	neutral
Windows also shuts the computer down for no reason without warning.	Windows	negative
It bluescreened on me without any warning, running simply basic Chrome.	Chrome	negative
although its windows vista compared to windows xp sucks.	windows xp	positive
With awesome graphics and assuring security, it's perfect!	graphics	positive
Its very nice and once you learn the features you will be so happy to have such a sophisticated computer.	features	neutral
-I propose that I can just swap the hard drives.	hard drives	neutral
it is very easy for anyone to use an apple and specially the mcbook pro notebook.	use	positive
We upgraded the memory to four gigabytes in order to take advantage of the performace increase in speed.	speed	positive
Garageband is easy to work with, like all the other apple applications I've had experience with.	Garageband	positive
I like how the Mac OS is so simple and easy to use.	use	positive
Supplied software: The software that comes with this machine is greatly welcomed compared to what Windows comes with.	software	positive
The screen is very large and crystal clear with amazing colors and resolution.	colors	positive
This is the first time that I tried and owning a netbook although I have used 3 different laptops in the past 10 years, I find not much difference except of course for the screen size.	screen size	neutral
THEN, one month after the warranty expired, the replacement charger went.	replacement charger	negative
I love the feel of the key board, as well as the trackpad.	trackpad	positive
I also liked the glass screen.	glass screen	positive
The best thing about this laptop is the price along with some of the newer features.	price	positive
I mainly use it for email, internet, and managing personal files (pics, vids, etc.).	internet	neutral
The processor screams, and because of the unique way that Apple OSX 16 functions, most of the graphics are routed through the hardware rather than the software.	software	neutral
Externally the keys on my keyboard are falling off, after a few uses the paint is rubbing off the button below the mouse pad and where the heals of my hands sit, and the screen has a terrible glare.	screen	negative
Garageband is more for the musicians, and the laptop is equipped with a good working microphone, good enough for beginners and musicians at the intermediate level.	Garageband	neutral
When I finally had everything running with all my software installed I plugged in my droid to recharge and the system crashed.	software	neutral
Right size and weight for portability.	weight	positive
/ awesome cooling system/ much better grafics card (ATI 5870) / 8GB RAM/ LED backlit screen...	cooling system	positive
not using wired lan not sure what thats about.	wired lan	neutral
Even with virus protection, it always turned off when updates were needed and installed.	updates	negative
Other installed features, such as certain printer software, are also most attractive.	features	positive
Another included program that is laughable is the chess game.	included program	negative
The screen is bright and vivid and the keyboard is very easy to use, very important for use quick typers.	keyboard	positive
Everything is so easy to use, Mac software is just so much simpler than Microsoft software.	Microsoft software	negative
In desparation, I called their Customer Service number and was told that my warranty had expired (2 days old) and that the priviledge of talking to a technician would cost me ("have your credit card ready").	Customer Service number	neutral
I am most impressed with the programming, including the iPhoto.	programming	positive
My main reason to convert was the imovie program.	imovie program	positive
I guess the only good thing that came out of these were the speakers and the subwoofer.	subwoofer	positive
The materials that came with the computer did not include the right # anywhere.	materials	negative
You have to toss out the wifi card and replace it just to have any sort of network capability.	wifi card	negative
The next time I had an issue my lightscribe wouldn't work.	lightscribe	negative
Hard disk - The new editions gives you more hard disk space (500GB instead of 320GB) but time has taught me never to trust an internal hard disk.	internal hard disk	neutral
I love the operating system and the preloaded software.	operating system	positive
BEST BUY - 5 STARS + + + (sales, service, respect for old men who aren't familiar with the technology) DELL COMPUTERS - 3 stars DELL SUPPORT - owes a me a couple	DELL SUPPORT	positive
Info: Windows failed to load because the kernal is missing, or corrupt.	Windows	negative
They went through asking me open up various components, taking battery out, hard disk apart, and after 2 hours on phone could not fix it.	hard disk	neutral
I'm really impressed with the quality and performance for the price of the computer.	performance	positive
However, I love this particular Mac because its very fast, great size, and has fantastic features like the lighted keyboard and easy mouse pad.	mouse pad	positive
oh yeah, and if the fancy webcam breaks guess who you have to send it to to get it fixed?	webcam	negative
BUT there's this application called Boot Camp which allows you to add another OS X like Windows.	Boot Camp	neutral
But sitting on a lap or on a desk in front of you it looks more than big enough (this could be because Im used to my Lenovo 10 tablet now) plus this is a great size if I want to unplug the external keyboard, mouse, and monitor to take it with me when I take photos and video.	monitor	neutral
The only thing that can be updated is the video, other than that you're all set.	video	negative
Battery is lasting about 6 hours as I am surfing the web on Sundays while checking football scores and watching funny Youtube videos.	Battery	neutral
The internet speed is spectacular.	internet speed	positive
But other than that I am blown away by all the features this laptop offers.	features	positive
Battery life needs more life.	Battery life	negative
It has a 10 hour battery life when you're doing web browsing and word editing, making it perfect for the classroom or office, and in terms of gaming and movie playing it'll have a battery life of just over 5 hours.	movie playing	neutral
The battery holds up well, it's built very solidly, and runs fast.	battery	positive
The screen is nice and the images comes very clear, the keyboard and the fit just feels right.	screen	positive
So, I took it back to the apple store and they narcissist genius bar staff) fixed it by resetting the fan at boot up.	fan	neutral
It's like 9 punds, but if you can look past it, it's GREAT!	9 punds	negative
Not easy to carry.	carry	negative
Peformance is good for the price.	price	positive
This is likely due to poor grounding and isolation between the components, and I'm hoping that it can be fixed with a ground loop isolator, but I still expected better product quality for this price range.	components	negative
Keyboard is great, very quiet for all the typing that I do.	Keyboard	positive
  But I needed a laptop for school use.	school use	neutral
This is a nicely sized laptop with lots of processing power and long battery life.	sized	positive
Simple to use, and great graphics.	use	positive
Its ease of use and the top service from Apple- be it their phone assistance or bellying up to the genius bar- cannot be beat.	use	positive
After a couple of years, my battery life began to diminish but was replaced for free due to a company-wide recall of my particular battery.	battery	negative
I dislike the weight and size, cubersome.	weight	negative
The battery life has not decreased since I bought it, so i'm thrilled with that.	battery life	positive
The 2 GB of RAM is plenty, able to run Windows 7 and at least 2 or 3 other programs with next to no slowdown.	2 GB of RAM	positive
It's so much easier to navigate through the operating system, to find files, and it runs a lot faster!	navigate	positive
The only thing that I have, is the key broad is a little dark to see the letters, would help if it was a little lighter then it is.	key broad	negative
Now for the hardware problems.	hardware	negative
The battery life was supposed to be 6 hours, but even if I ran off the battery with the high effeciency setting the battery would only last me on average about 2.5 to 3 hours.	battery life	negative
All of the programs (Keynote, Pages, Numbers) have an option to save your documents as Microsoft compatible, which really eliminates the need for the actual.	Pages	neutral
The size is perfect and I do not recomend anything bigger except for any person who can exceed the limited space it gives you.	space	negative
It is short on space, and downloads always had problems being completed, or were said to be 'corrupted'.	downloads	negative
I dual boot with Linux and that other security-prone OS and it performs flawlessly.	Linux	neutral
The magnetic plug-in power charging power cord is great (I even put it to the test by accident)- excellent innovation!	magnetic plug-in power charging power cord	positive
Ever since I bought this laptop, so far I've experience nothing but constant break downs of the laptop and bad customer services I received over the phone with toshiba customer services hotlines.	toshiba customer services	negative
For the same price, you get a lot more in the Asus....1920x1080 res.	price	negative
I'm already hooked on the sleek look and dependability that this laptop has shown.	look	positive
It is stamped and not in pieces therefore it is a stronger more resilient frame.	frame	positive
It gives me the power and speed that I need to run all the programs I use to edit.	speed	positive
It was heavy,bulky, and hard to carry because of the size.	size	negative
This is the complete opposite to an ergonomic design.	design	negative
I run Dreamweaver, Final Cut Pro 7, Photoshop, Safari, Firefox, MSN Messenger and a few other applications constantly at the same time.	Final Cut Pro 7	neutral
I never had this kind of quality issue with Dell (not to say Dell is that great), not with a brand new laptop.	quality	negative
I hate the display screen and I have done everything I could do the change it.	display screen	negative
Returned laptop for repair a 2nd time and it came back with obvious physical damage (keyboard bulging and speaker grill pressed in), buttons not working and USB ports inoperative.	USB ports	negative
That included the extra Sony Sonic Stage software, the speakers and the subwoofer I got (that WAS worth the money), the bluetooth mouse for my supposedly bluetooth enabled computer, the extended life battery and the Docking port.	Sony Sonic Stage software	neutral
Overall I feel this netbook was poor quality, had poor performance, although it did have great battery life when it did work.	quality	negative
I reloaded with Windows 7 Ultimate, and the Bluetooth and Fingerprint reader (software) would not load.	Bluetooth	negative
This is likely due to poor grounding and isolation between the components, and I'm hoping that it can be fixed with a ground loop isolator, but I still expected better product quality for this price range.	quality	negative
Waiting for the i7 was well worth it, great value for the price.	i7	positive
Speaking of the browser, it too has problems.	browser	negative
I just plug this into my 22" Monitor and the speedy MacOSX performs just as well on this dual-core that my Dell did with Windows 7 with a quad-core.	22" Monitor	neutral
Overall, this laptop is definitely a keeper with its simple yet stylish design and its array of fantastic colors to choose from.	design	positive
  It is easy to use, fast and has great graphics for the money.	graphics	positive
When you look at the specs on Apple products in comparison to a Dell or a HP, yes they do seem to offer less for a higher cost.	cost	negative
THEN, one month after the warranty expired, the replacement charger went.	warranty	neutral
The 17 inch screen is very large, but the computer is very light.	17 inch screen	negative
We paid for the three year warranty and the extended warranty after that one ended as well.	three year warranty	neutral
(I had been a Windows/Linux user before this) I love the size because the screen is big enough for what I use it for (Internet, artwork), and yet it is small enough to be reasonably portable.	Linux	neutral
We figure that after everything HIS pc actually ended up costing $350 more than my original Mac.	costing	negative
GET THIS COMPUTER FOR PORTABILITY AND FAST PROCESSING!!!	PROCESSING	positive
The machine is slow to boot up and occasionally crashes completely.	boot up	negative
Enjoy that Toshib force and durability unparalleled	durability	positive
Adjust the sensitivity since it's not that responsive to begin with.	sensitivity	negative
The only problems are the sound isnt very loud I have to wear headphones.	sound	negative
Everything from the design to the OS is simple and to the point.	OS	positive
The computer runs very fast with no problems and the iLife software that comes with it (iPhoto, iMovie, iWeb, iTunes, GarageBand) is all very helpful as well.	iWeb	positive
The LED backlit display makes my pictures pop so much more.	LED backlit display	positive
And the ram (the thing that makes it faster) comes sporting 2 gigs for high performance to handle more stuff at once and surf the web a whole lot faster than before.	ram	positive
It didn't take me long to get switched over to the Mac computer programs and navigation - it's been just fine and like the way this laptop functions much better.	navigation	positive
And if you have a iphone or ipod touch you can connect and download songs to it at high speed.	speed	positive
I got it back and my built-in webcam and built-in mic were shorting out anytime I touched the lid, (mind you this was my means of communication with my fiance who was deployed) but I suffered thru it and would constandly have to reset the computer to be able to use my cam and mic anytime they went out.	built-in mic	negative
One suggestion I do have, is to not bother getting Microsoft office for the mac expecting it will work just like you knew it to on a PC.	Microsoft office for the mac	negative
The only objection I have is that after you buy it the windows 7 system is a starter and charges for the upgrade.	windows 7 system	negative
It is easy to use, good quality and good price.	quality	positive
The only problem is a lack of screen resolutions!	screen resolutions	negative
It's software and speed enable it to do amazing things.	software	positive
The ATI graphics card is a huge plus, definitely a good value if you need to be able to run some slightly older games that a Intel built-in card would have trouble with, such as Half-Life 2 or even World of Warcraft.	ATI graphics card	positive
My wireless system would not recognize Windows 7 and I couldn't get online to find out why.	wireless system	negative
It is easy to use, has great screen quality, and every so light weight.	screen quality	positive
It is in the best condition and has a really high quality.	quality	positive
I previously purchased a 13" macbook (had pro specs and was aluminum style) which had a nvidia 9800 (If I am not mistaken) and it had major heating issues.	specs	positive
Quality Display  I was surprised with the performance and quality of this HP Laptop.	performance	positive
I had purchased it from a major electronics store and took it to their service department to find out what the problem was.	service department	neutral
That's very possible, but since they don't make Windows XP drivers for the sound card in this machine, I was stuck until Windows 7 came out.	Windows 7	positive
Good for every day computing and web browsing.	every day computing	positive
I did think it had a camera because that was one of my requirements, but forgot to check in the specifications on this one before I purchased.	specifications	neutral
  However the frozen screens kept happening.	screens	negative
I had my IWORKS, Itunes, Email, MS Office, network and printers set up and completely working perfectly within an hour.	IWORKS	positive
For those that care about noise this thing doesn't really make any;	noise	positive
The Material this Pro is made out of seems a lot nicer than any PC  Specs: Like I said this performs a lot better than any computer I've had in the past.	Material	positive
It works great for general internet use, Microsoft Office apps, home bookkeeping, etc.	internet use	positive
It seems they could have updated XP and done without creating Vista.	Vista	negative
That included the extra Sony Sonic Stage software, the speakers and the subwoofer I got (that WAS worth the money), the bluetooth mouse for my supposedly bluetooth enabled computer, the extended life battery and the Docking port.	extended life battery	neutral
I am overall very pleased with my toshiba satellite, I like the extra features, I love the windows 7 home premium.	extra features	positive
So what am I supposed to do?  The LG service center cannot provide me the "service" when it is called the "service center".	service	negative
I love WIndows 7 which is a vast improvment over Vista.	Vista	negative
I use this for my tutoring business, and since I'm always bouncing from student to student, it is ideal for portability and battery life (yes, it gets the 8 hours as advertised!).	battery life	positive
And if you do a lot of writing, editing is a problem since there is no  forward delete  key.	delete  key	negative
The tech guy then said the service center does not do 1-to-1 exchange and I have to direct my concern to the "sales" team, which is the retail shop which I bought my netbook from.	"sales" team	negative
I have never really been big on downloading anything so I wasn't too worried about getting a virus, plus I thought I was protected by Norton.	Norton	negative
I did not have to call the support line at all.	support line	neutral
Its a good laptop for its value.	value	positive
Now mainboard is broken, have to wait for a new one.	mainboard	negative
The screen is framed by half- to a full-inch margin that is obviously unnecessary, reduces the screen size and increases the bulk.	bulk	negative
Tried to make a recovey disk wouldnt get passed the first recovery disk.	recovery disk	negative
The Aspire wont even boot past the Acer screen with a Droid (I have tried both Motorola and HTC) plugged into the USB port.	Acer screen	negative
The DVD drive randomly pops open when it is in my backpack as well, which is annoying.	DVD drive	negative
Keyboard is reasonable size.	Keyboard	positive
Compared to similarly spec'd PCs, this machine is good value, well built and works easily right out of the box.	works	positive
Take your time and go through the tutorials patiently.	tutorials	neutral
This computer is exceptionally thin for it's screen size and processing power.	processing power	positive
They only stay charged a little over an hour.	charged	negative
you can find many laptops with the same performance and even better with lower price, but you cannot find the look, easy, applications, and the experience in mac.	look	positive
The reality was, it heated up very quickly, and took way too long to do simple things, like opening my Documents folder.	opening my Documents folder	negative
I loved the netbook (minus the fact that it was windows OS) until this started happening.	windows OS	negative
While most people say that PCs hold functionality and value and Macs are just pretty to look at, I think there's something to be said about the simplicity of Macs.	functionality	positive
Very long-life battery (up to 10-11 hours depending on how you configure power level settings).	battery	positive
You can call HP and they want you to buy more software to fix it.	software	neutral
Can listen to my music and watch my videos with ease and with a great display.	display	positive
The pricing is very competitive.	pricing	positive
I love its solid build, light wt and excellent battery life (for now).	battery life	positive
Has a 5-6 hour battery life.	battery life	neutral
power supply went bad after 2 weeks --	power supply	negative
The computer runs extremely slowly, whether opening Word or My Computer.	runs	negative
Returned laptop for a 3rd repair and it came back with previous problems fixed (except for speaker grill) but the unit started locking up during use and eventually would not operate at all.	speaker grill	negative
If a website ever freezes (which is rare), its really easy to force quit.	force quit	positive
Excellent LED monitor and well equipped.	LED monitor	positive
The programs are great, like iphoto (love the editing capabilities), imail (which can incorporate with the address book on the ipod and ipad), imovie, etc.	imail	positive
The image is great, and the soud is excelent.	image	positive
But we had paid for bluetooth, and there was none.	bluetooth	negative
The DVD burner broke after burning 3 DVD'd during that time!	DVD burner	negative
  The hard drive crashed as well, and I had to buy a new  power cord.	hard drive	negative
Design: very durable.	Design	positive
Though the picture, video, and music software is nowhere close to professional grade software Im used to (CS5) but does the job for beginner and even intermediate media designers.	picture	negative
It has a 10 hour battery life when you're doing web browsing and word editing, making it perfect for the classroom or office, and in terms of gaming and movie playing it'll have a battery life of just over 5 hours.	gaming	neutral
There are several programs for school or office use (Pages, Numbers, Keynote, etc.), music (Garageband), photo management (Photo Booth, iPhoto), video-editing or movie-making (iMovie), etc.	movie-making	neutral
The processor is very quick and effective as I load webpages and applications.	webpages	neutral
